====================
=>..=.=...=...=.=.==
=.===.=.=.===.=.=.==
=.......=.....=....=
=.=.=.===.===.===.==
=.=.=...=.=.....=..=
=.=====.=.=======.==
=.=...=.=.......=.==
=.===.===.=======.==
=.=.=.=.=...=......=
=.=.=.=.=.=====.====
=.....=.......=...==
===========.=====.==
=.=...=...=...=...==
=.=.=====.=.=====.==
=...=.=.=.=.......==
=.===.=.=.===.===.==
=...=G..=.....=....=
=.....=.....=......=
====================

